-19
20
-9
8
0000000000000000000000000000000000000000
0000000000000000000000000000000000000000
0000000000000000000000000000000000000000
0000000000000000000000000000000000000000
0000000000000000000000000000000000000000
0000000000000000000000000000000000000000
0000000000000000000000000111111100000000
0000000000000000000000000111111100000000
0000000000100000000000000111111100000000
0000000000000000000000000111111100000000
0000000000001000000000000111111100000000
0000000000000000100000000111111100000000
0000000000000000000000000111111100000000
0000000000000000000000000000000000000000
0000000000000000000000000000000000000000
0000000000000000000000000000000000000000
0000000000000000000000000000000000000000
0000000000000000000000000000000000000000
