-9
13
-4
3
00000000000000000000000
00000000000000011111110
00000000000000011111110
10000000000000011111110
00000000000000011111110
00100000000000011111110
00000010000000011111110
00000000000000011111110
